0000000000000000
3333333333333333
3333333333333333
3333333333333333
1111111111111111
3333333333333333
0000000000000000
3333333333333333
1111111111111111
3333333333333333
3333333333333333
3333333333333333
0000000000000000
3333333333333333
4444444444444444
4444444444444444
4444444444444444
0000000000000000
0000000000000000
0000000000000000
0000000000000000
0000000000000000
0000000000000000
0000000022222222
0000000022222222
0000000022222222
3333333322222222
4444444444444444
4444444444444444
4444444444444444
3333333333333333
3333333333333333
3333333333333333
3333333333333333
3333333333333333
3333333333333333
3333333333333333
3333333333333333
3333333333333333
5555555555555555
4444444444444444
4444444444444444
4444444444444444
0000000000000000
0000000000000000
0000000000000000
1111111111111111
0000000000000000
1111111111111111
1111111111111111
1111111111111111
1111111111111111
5555555555555555
4444444444444444
4444444444444444
4444444444444444
1111111111111111
1111111111111111
0000000011111111
1111111100000000
0000000000000000
1111111111111111
0000000000000000
0011001100110011
0000000000000000
5555555555555555
4444444444444444
4444444444444444
4444444444444444
0000000000000000
0000000000000000
1111111111111111
0000000000000000
0000000000000000
0000000000000000
0000000000000000
0011001100110011
0000000000000000
5555555555555555
4444444444444444
3333333333333333
3333333333333333
3333333333333333
3333333333333333
2222222222222222
2222222222222222
2222222222222222
3333333333333333
3333333333333333
4444444444444444
3333333333333333
5555555555555555
0000000011111111
0000000000000000
0000000011111111
0000000000000000
0000000000000000
0000000000000000
0000000000000000
0000000000000000
4444444444444444
4444444444444444
4444444444444444
4444444444444444
2222222222222222
1111111111111111
1111111111111111
1111111111111111
1100110011001100
0011001100110011
1111111100000000
1111111100000000
1111111100000000
4444444444444444
4444444444444444
4444444444444444
4444444444444444
1111111111111111
0000000000000000
0000000000000000
0000000000000000
0000000000000000
1111111111111111
0000000000000000
0000000011111111
0000000011111111
4444444444444444
4444444444444444
4444444444444444
4444444444444444
1111111111111111
0000000000000000
0000000000000000
2200220022002200
0000000000000000
0000000000000000
0000000000000000
1111111100000000
1111111100000000
5555555555555555
4444444444444444
4444444444444444
5555555555555555
1111111111111111
1111111111111111
0000000000000000
2200220022002200
0000000000000000
0000000000110011
0000000011111111
0000000011001100
0000000000000000
4444444444444444
4444444444444444
4444444444444444
5555555555555555
2222222222222222
1111111111111111
1111111111111111
1111111111111111
0000000000000000
0011001100110011
6666666666666666
1100110011001100
0000000000000000
1111111111111111
1111111111111111
0000000000000000
0000000000000000