0000000000000000
3333333333333333
3333333333333333
3333333333333333
3333333333333333
0011001100110011
0000000000000000
1100110011001100
4444444444444444
4444444444444444
3333333333333333
3333333333333333
0000000000000000
3333333333333333
1100110011001100
0022002200220022
0000000000000000
1100110011001100
0000000000000000
0000000000000000
0000000000000000
0011001100110011
4444444444444444
1100110011001100
0011001100110011
4444444444444444
3333333333333333
1100110011001100
0022002200220022
0000000000000000
1100110011001100
0000000000000000
1111111111111111
0000000000000000
0011001100110011
4444444444444444
1100110011001100
0011001100110011
4444444444444444
3333333333333333
1111111111111111
0000000000000000
0000000000000000
1111111111111111
1111111111111111
2222222222222222
1111111111111111
1111111111111111
4444444444444444
0000000000000000
1111111111111111
4444444444444444
3333333333333333
0000000000000000
0000000000000000
0011001100110011
2222222200000000
1111111100000000
1111111111111111
1100110011001100
1111111100000000
2222222200000000
0000000000000000
4444444444444444
4444444444444444
1111111111111111
1111111111111111
1100110011001100
0000000000000000
0000000000000000
4444444444444444
1111111111111111
4444444444444444
0000000000000000
0000000000000000
0011001100110011
1111111111111111
1111111111111111
5555555555555555
3333333333333333
3333333333333333
3333333333333333
0011001100110011
4444444444444444
4444444444444444
4444444444444444
1100110011001100
3333333333333333
3333333333333333
3333333333333333
5555555555555555
2222222222222222
1111111111111111
1111111111111111
0000000000000000
1111111100000000
4444444444444444
4444444444444444
4444444444444444
1111111100000000
0000000000000000
1111111111111111
1111111111111111
2222222222222222
2222222200000000
2222222200000000
2222222200000000
0000000000000000
0000000011111111
0000000000000000
4444444444444444
0000000000000000
0000000011111111
0000000000000000
2222222200000000
2222222200000000
2222222200000000
3333333333333333
1111111111111111
3333333333333333
3333333333333333
1111111111111111
0000000000000000
0000000000000000
0000000000000000
2222222222222222
3333333333333333
3333333333333333
3333333333333333
3333333333333333
4444444444444444
1111111111111111
1100110011001100
0000000000000000
0000000000000000
1111111100000000
0000000000000000
1111111100000000
0000000000000000
0000000000000000
0011001100110011
1111111111111111
4444444444444444
0000000000000000
0000000000000000
1111111100000000
0000000000000000
0000000000000000
0000000000110011
0000000011111111
0000000011001100
0000000000000000
0000000000000000
4444444444444444
4444444444444444
4444444444444444
0000000000000000
0000000000000000
2222222222222222
0000000000000000
0000000000000000
0011001100110011
6666666666666666
1100110011001100
0000000000000000
0000000000000000
0000000011111111
4444444444444444
4444444444444444