0000000000000000
4444444444444444
4444444444444444
4444444444444444
4444444444444444
4444444444444444
0000000000000000
4444444444444444
4444444444444444
4444444444444444
4444444444444444
4444444444444444
0000000000000000
3333333333333333
3333333333333333
3333333333333333
0000000000000000
1111111111111111
1111111111111111
1111111111111111
0000000000000000
1111111111111111
0000000000000000
3333333333333333
3333333333333333
3333333333333333
0000000000000000
0000000000000000
3333333333333333
0000000000000000
1111111111111111
0000000000000000
1111111111111111
0000000000000000
1111111111111111
0000000000000000
3333333333333333
0000000000000000
3333333333333333
3333333333333333
3333333333333333
3333333333333333
0000000000000000
1111111111111111
0000000000000000
1111111111111111
0000000000000000
1111111111111111
0000000000000000
3333333333333333
0000000000000000
3333333333333333
3333333333333333
0000000000000000
0000000000000000
0000000000000000
1111111111111111
0000000000000000
1111111111111111
0000000000000000
1111111111111111
0000000000000000
3333333333333333
0000000000000000
3333333333333333
3333333333333333
3333333333333333
3333333333333333
0000000000000000
1111111111111111
1111111111111111
1111111111111111
0000000000000000
1111111111111111
0000000000000000
3333333333333333
3333333333333333
3333333333333333
4444444444444444
4444444444444444
4444444444444444
4444444444444444
4444444444444444
4444444444444444
4444444444444444
4444444444444444
4444444444444444
4444444444444444
4444444444444444
4444444444444444
4444444444444444
2222222222222222
0000000000000000
0000000000000000
0000000000000000
0000000000000000
0000000011111111
2222222222222222
0000000011111111
0000000000000000
0000000000000000
0000000000000000
0000000000000000
2222222222222222
4444444444444444
0000000011111111
0000000000000000
0000000011111111
0000000000000000
1111111111111111
1111111111111111
1111111111111111
0000000000000000
0000000011111111
0000000000000000
0000000011111111
4444444444444444
4444444444444444
1111111111111111
2222222222222222
1111111111111111
2222222222222222
1111111111111111
1111111111111111
1111111111111111
2222222222222222
1111111111111111
2222222222222222
1111111111111111
4444444444444444
4444444444444444
1111111111111111
0000000000000000
1111111111111111
0000000000000000
1111111100000000
0000000000000000
1111111100000000
0000000000000000
1111111111111111
0000000000000000
1111111111111111
4444444444444444
4444444444444444
1111111111111111
0000000000000000
1111111111111111
0000000000000000
0000000000110011
0000000011111111
0000000011001100
0000000000000000
1111111111111111
0000000000000000
1111111111111111
4444444444444444
4444444444444444
4444444444444444
4444444444444444
0000000000000000
0000000000000000
0011001100110011
6666666666666666
1100110011001100
0000000000000000
0000000000000000
4444444444444444
4444444444444444
4444444444444444